##################
#................#
#................#
#...##########...#
#.......##.......#
#####..####..#####
#......####......#
#..############..#
#......####......#
#####..####..#####
#.......##.......#
#...##########...#
#................#
##################


